{
  "id": 5,
  "name": "Rainy Daze",
  "weather": "rain",
  "npcs": [],
  "grid": [
    [0,0,0,0,0,0,0,0,0,0,0,0,0,0,0,0,0,0,0,0,0,0,0,0,0,0,0,0],
    [0,0,0,0,0,0,0,0,0,0,0,0,0,0,0,0,0,0,0,0,0,0,0,0,0,0,0,6],
    [0,7,0,0,0,0,0,0,0,0,0,0,7,0,0,7,0,0,0,0,0,0,0,0,0,7,0,0],
    [1,1,1,3,1,1,1,1,1,1,1,1,1,1,3,1,1,1,1,1,1,1,1,1,3,1,1,1],
    [0,0,0,3,0,0,0,0,0,0,0,0,0,0,3,0,0,0,0,0,0,0,0,0,3,0,0,0],
    [4,4,4,3,4,4,4,4,4,4,0,0,0,0,3,0,0,0,4,4,4,4,4,4,3,4,4,4],
    [0,0,0,3,0,0,0,0,0,0,0,0,0,0,3,0,0,0,0,0,0,0,0,0,3,0,0,0],
    [0,0,0,3,0,0,8,0,0,0,0,0,0,0,3,0,0,0,0,0,8,0,0,0,3,0,0,0],
    [1,1,1,3,1,1,1,1,1,0,0,0,0,0,3,0,0,0,0,1,1,1,1,1,3,1,1,1],
    [0,0,0,3,0,0,0,0,0,0,0,0,0,0,3,0,0,0,0,0,0,0,0,0,3,0,0,0],
    [0,0,0,3,0,0,0,0,4,4,4,4,4,4,3,4,4,4,4,4,0,0,0,0,3,0,0,0],
    [0,7,0,3,0,0,0,0,0,0,0,0,0,0,3,0,0,0,0,0,0,0,0,0,3,0,7,0],
    [1,1,1,3,1,1,1,1,1,1,1,1,1,1,3,1,1,1,1,1,1,1,1,1,3,1,1,1],
    [9,0,0,3,0,0,0,0,0,0,0,0,0,0,3,0,0,0,0,0,0,0,0,0,3,0,0,0],
    [1,1,1,1,1,1,1,1,1,1,1,1,1,1,1,1,1,1,1,1,1,1,1,1,1,1,1,1],
    [1,1,1,1,1,1,1,1,1,1,1,1,1,1,1,1,1,1,1,1,1,1,1,1,1,1,1,1]
  ]
}
