{
  "id": 3,
  "name": "Dig Deep",
  "theme": "nature-3",
  "weather": "none",
  "exitColumn": 13,
  "powerHelmet": { "x": 13, "y": 7 },
  "npcs": [],
  "grid": [
    [0,0,0,0,0,0,0,0,0,0,0,0,0,0,0,0,0,0,0,0,0,0,0,0,0,0,0,0],
    [0,0,0,7,0,0,0,0,0,0,0,0,0,0,0,0,0,0,0,0,0,0,0,0,7,0,0,0],
    [1,1,1,1,1,3,0,0,0,0,0,0,0,0,0,0,0,0,0,0,0,0,0,3,1,1,1,1],
    [0,0,0,0,0,3,0,0,0,0,0,0,0,0,0,0,0,0,0,0,0,0,0,3,0,0,0,0],
    [0,0,0,0,0,3,0,0,0,0,0,7,0,8,0,0,7,0,0,0,0,0,0,3,0,0,0,0],
    [0,0,0,0,0,3,0,0,0,0,1,1,1,3,1,1,1,1,0,0,0,0,0,3,0,0,0,0],
    [0,0,0,0,0,3,0,0,0,0,0,0,0,3,0,0,0,0,0,0,0,0,0,3,0,0,0,0],
    [0,0,0,0,0,3,0,0,0,0,0,0,0,3,0,0,0,0,0,0,0,0,0,3,0,0,0,0],
    [0,0,8,0,0,3,0,0,0,0,0,0,0,3,0,0,0,0,0,0,8,0,0,3,0,0,0,0],
    [1,1,1,1,1,3,4,4,4,4,4,4,4,3,4,4,4,4,4,4,3,1,1,1,1,1,1,1],
    [0,0,0,0,0,3,0,0,0,0,0,0,0,3,0,0,0,0,0,0,3,0,0,0,0,0,0,0],
    [0,0,0,0,0,3,0,0,0,0,0,0,0,3,0,0,0,0,0,0,3,0,0,0,0,0,0,0],
    [0,0,0,0,0,3,0,0,7,0,0,0,0,3,0,0,0,0,7,0,3,0,0,0,0,0,0,0],
    [0,0,0,0,0,3,1,1,1,1,1,1,1,3,1,1,1,1,1,1,3,0,0,0,0,0,0,0],
    [0,0,0,0,0,3,0,0,0,0,0,0,0,3,0,0,0,0,0,0,3,0,0,0,0,0,0,0],
    [0,0,0,0,0,3,0,0,0,0,0,0,0,3,0,0,0,0,0,0,3,0,0,0,0,0,0,0],
    [0,0,0,0,0,3,0,0,0,0,0,0,0,3,0,0,0,0,0,0,3,0,0,0,0,0,0,0],
    [9,0,0,0,0,3,0,0,0,0,0,0,0,3,0,0,0,0,0,0,3,0,0,0,0,0,0,0],
    [1,1,1,1,1,1,1,1,1,1,1,1,1,1,1,1,1,1,1,1,1,1,1,1,1,1,1,1],
    [1,1,1,1,1,1,1,1,1,1,1,1,1,1,1,1,1,1,1,1,1,1,1,1,1,1,1,1]
  ]
}
