{
  "id": 2,
  "name": "Rope Tricks",
  "weather": "none",
  "npcs": [],
  "grid": [
    [0,0,0,0,0,0,0,0,0,0,0,0,0,0,0,0,0,0,0,0,0,0,0,0,0,0,0,0],
    [0,0,0,0,0,0,0,0,0,0,0,0,0,0,0,0,0,0,0,0,0,0,0,0,0,0,0,6],
    [0,7,0,0,0,0,0,0,0,0,0,0,0,0,0,0,0,0,0,0,0,0,0,0,0,0,7,0],
    [1,1,1,0,0,0,0,3,0,0,0,0,0,0,0,0,0,0,0,0,3,0,0,0,0,1,1,1],
    [0,0,0,0,0,0,0,3,0,0,0,0,0,7,0,0,0,0,0,0,3,0,0,0,0,0,0,0],
    [0,0,0,4,4,4,4,3,4,4,4,4,1,1,1,1,4,4,4,4,3,4,4,4,4,0,0,0],
    [0,0,0,0,0,0,0,3,0,0,0,0,0,0,0,0,0,0,0,0,3,0,0,0,0,0,0,0],
    [0,0,0,0,0,0,0,3,0,0,0,0,0,8,0,0,0,0,0,0,3,0,0,0,0,0,0,0],
    [0,7,0,0,0,0,0,3,0,0,0,0,1,1,1,1,0,0,0,0,3,0,0,0,0,7,0,0],
    [1,1,1,1,0,0,0,3,0,0,0,0,0,0,0,0,0,0,0,0,3,0,0,0,1,1,1,1],
    [0,0,0,0,0,0,0,3,0,0,0,0,0,0,0,0,0,0,0,0,3,0,0,0,0,0,0,0],
    [0,0,0,4,4,4,4,3,4,4,4,4,4,4,4,4,4,4,4,4,3,4,4,4,4,0,0,0],
    [0,0,0,0,0,0,0,3,0,0,7,0,0,0,0,0,0,7,0,0,3,0,0,0,0,0,0,0],
    [9,0,0,0,0,0,0,3,0,1,1,1,1,1,1,1,1,1,1,0,3,0,0,0,0,0,0,0],
    [1,1,1,1,1,1,1,1,1,1,1,1,1,1,1,1,1,1,1,1,1,1,1,1,1,1,1,1],
    [1,1,1,1,1,1,1,1,1,1,1,1,1,1,1,1,1,1,1,1,1,1,1,1,1,1,1,1]
  ]
}
